      _       _      
     (_\     /_)     
       ))   ((       
     .-"""""""-.     
 /^\/  _.   _.  \/^\ 
 \(   /__\ /__\   )/ 
  \,  \o_/_\o_/  ,/  
    \    (_)    /    
     `-.'==='.-'     
      __) - (__      
     /  `~~~`  \     
    /  /     \  \    
    \ :       ; /    
     \|==(*)==|/     
      :       :      
       \  |  /       
     ___)=|=(___     
